***********************
*E    * *             *
***** * ***** ******* *
*     *   *         *S*
*** ***** *** ***** ***
*       *   * *     * *
* ***** *** *** * * * *
* *   *   *     * *   *
* * * *** * * *** * ***
*   * *     * *       *
***********************